NO textures/wolf/grey.xpm
SO textures/wolf/notsure.xpm
WE textures/wolf/bluestuff.xpm
EA textures/wolf/green.xpm

F 220,100,0
C 225,30,0

1111111
1100E11
1111111
1111111
